,0,1,2,3,4,5,6,7,8,9,10,11,12,13,14,15,16,17,18,19
0,0,1,1,1,1,0,0,0,0,0,0,1,1,0,1,1,0,1,1,0
1,1,0,0,0,0,1,0,1,0,0,1,0,0,0,1,0,1,1,1,0
2,1,0,0,1,0,0,0,0,0,0,0,0,1,0,0,1,0,0,0,0
3,1,0,1,0,0,0,1,0,1,0,0,0,1,0,0,1,0,0,1,0
4,1,0,0,0,0,0,1,0,1,0,0,1,0,1,1,1,0,1,1,0
5,0,1,0,0,0,0,0,0,0,0,0,0,0,0,0,0,1,0,0,0
6,0,0,0,1,1,0,0,0,1,1,0,0,1,1,0,1,1,1,0,1
7,0,1,0,0,0,0,0,0,0,0,0,0,0,0,0,0,0,0,0,0
8,0,0,0,1,1,0,1,0,0,1,1,0,0,0,1,0,0,0,0,0
9,0,0,0,0,0,0,1,0,1,0,0,0,1,1,0,0,1,0,0,0
10,0,1,0,0,0,0,0,0,1,0,0,1,0,0,1,1,1,1,1,1
11,1,0,0,0,1,0,0,0,0,0,1,0,0,1,1,1,0,1,0,1
12,1,0,1,1,0,0,1,0,0,1,0,0,0,0,1,0,0,0,0,0
13,0,0,0,0,1,0,1,0,0,1,0,1,0,0,0,1,0,1,1,0
14,1,1,0,0,1,0,0,0,1,0,1,1,1,0,0,0,0,1,1,1
15,1,0,1,1,1,0,1,0,0,0,1,1,0,1,0,0,0,0,0,1
16,0,1,0,0,0,1,1,0,0,1,1,0,0,0,0,0,0,0,0,1
17,1,1,0,0,1,0,1,0,0,0,1,1,0,1,1,0,0,0,0,1
18,1,1,0,1,1,0,0,0,0,0,1,0,0,1,1,0,0,0,0,1
19,0,0,0,0,0,0,1,0,0,0,1,1,0,0,1,1,1,1,1,0
