,0,1,2,3,4,5,6,7,8,9,10,11,12,13,14,15,16,17,18,19
0,0,0,0,0,0,1,1,1,1,1,1,0,0,0,1,1,0,0,0,0
1,0,0,1,1,1,0,0,0,0,0,0,1,0,0,0,0,0,1,0,1
2,0,1,0,0,1,0,0,0,1,0,0,1,0,1,1,1,0,1,1,0
3,0,1,0,0,0,0,1,1,1,0,1,0,0,1,0,1,1,0,0,0
4,0,1,1,0,0,0,0,0,0,0,0,1,0,1,0,0,0,0,0,0
5,1,0,0,0,0,0,0,0,0,0,1,0,0,1,0,1,0,0,0,1
6,1,0,0,1,0,0,0,1,1,1,0,0,1,1,0,1,0,0,0,0
7,1,0,0,1,0,0,1,0,0,0,1,0,0,1,0,1,1,0,0,0
8,1,0,1,1,0,0,1,0,0,1,0,0,0,0,0,1,1,0,0,0
9,1,0,0,0,0,0,1,0,1,0,1,0,1,1,0,0,1,1,0,0
10,1,0,0,1,0,1,0,1,0,1,0,0,1,0,1,0,0,1,0,0
11,0,1,1,0,1,0,0,0,0,0,0,0,0,1,0,0,0,0,0,0
12,0,0,0,0,0,0,1,0,0,1,1,0,0,1,0,0,0,0,0,1
13,0,0,1,1,1,1,1,1,0,1,0,1,1,0,1,1,1,0,1,1
14,1,0,1,0,0,0,0,0,0,0,1,0,0,1,0,0,0,1,0,1
15,1,0,1,1,0,1,1,1,1,0,0,0,0,1,0,0,0,0,0,1
16,0,0,0,1,0,0,0,1,1,1,0,0,0,1,0,0,0,1,0,0
17,0,1,1,0,0,0,0,0,0,1,1,0,0,0,1,0,1,0,0,0
18,0,0,1,0,0,0,0,0,0,0,0,0,0,1,0,0,0,0,0,0
19,0,1,0,0,0,1,0,0,0,0,0,0,1,1,1,1,0,0,0,0
