,0,1,2,3,4,5,6,7,8,9,10,11,12,13,14,15,16,17,18,19
0,0,1,1,0,1,1,0,0,0,0,0,1,0,0,1,1,0,0,0,0
1,1,0,0,1,1,0,0,0,0,0,0,0,0,0,1,0,0,1,0,0
2,1,0,0,1,1,0,1,1,0,0,0,1,1,0,0,0,1,1,0,0
3,0,1,1,0,1,1,1,0,0,1,0,0,0,1,1,1,1,0,0,1
4,1,1,1,1,0,1,0,1,0,0,0,1,1,0,0,0,0,0,1,0
5,1,0,0,1,1,0,1,0,0,0,0,0,1,0,0,0,0,0,1,1
6,0,0,1,1,0,1,0,1,0,0,0,0,0,0,0,0,0,0,1,0
7,0,0,1,0,1,0,1,0,0,0,0,0,1,1,0,0,1,0,1,1
8,0,0,0,0,0,0,0,0,0,0,0,0,1,0,0,0,1,1,0,1
9,0,0,0,1,0,0,0,0,0,0,0,0,0,0,0,0,0,0,1,0
10,0,0,0,0,0,0,0,0,0,0,0,0,0,0,0,0,0,0,1,0
11,1,0,1,0,1,0,0,0,0,0,0,0,0,1,0,1,0,1,0,1
12,0,0,1,0,1,1,0,1,1,0,0,0,0,1,0,0,0,1,0,0
13,0,0,0,1,0,0,0,1,0,0,0,1,1,0,0,0,0,0,1,0
14,1,1,0,1,0,0,0,0,0,0,0,0,0,0,0,1,0,0,1,1
15,1,0,0,1,0,0,0,0,0,0,0,1,0,0,1,0,0,0,0,1
16,0,0,1,1,0,0,0,1,1,0,0,0,0,0,0,0,0,0,1,1
17,0,1,1,0,0,0,0,0,1,0,0,1,1,0,0,0,0,0,0,0
18,0,0,0,0,1,1,1,1,0,1,1,0,0,1,1,0,1,0,0,1
19,0,0,0,1,0,1,0,1,1,0,0,1,0,0,1,1,1,0,1,0
