,0,1,2,3,4,5,6,7,8,9
0,0,0,0,0,1,0,0,1,0,0
1,0,0,1,1,0,1,1,1,1,1
2,0,1,0,0,0,0,1,1,0,0
3,0,1,0,0,0,1,0,1,0,0
4,1,0,0,0,0,0,1,1,0,0
5,0,1,0,1,0,0,1,0,0,0
6,0,1,1,0,1,1,0,0,1,1
7,1,1,1,1,1,0,0,0,1,1
8,0,1,0,0,0,0,1,1,0,0
9,0,1,0,0,0,0,1,1,0,0
