,0,1,2,3,4,5,6,7,8,9,10,11,12,13,14,15,16,17,18,19
0,0,0,0,0,0,0,0,0,0,0,0,0,0,0,1,1,0,0,1,0
1,0,0,0,1,0,1,0,0,0,0,0,0,0,0,0,1,1,1,0,0
2,0,0,0,0,0,1,0,0,0,0,1,0,1,1,0,0,1,1,0,0
3,0,1,0,0,0,0,0,0,0,0,0,0,0,0,0,0,1,0,0,1
4,0,0,0,0,0,1,0,0,0,0,0,0,0,1,0,1,0,1,0,0
5,0,1,1,0,1,0,1,0,0,1,1,1,0,1,0,0,0,1,1,1
6,0,0,0,0,0,1,0,1,0,0,0,0,0,0,0,0,0,0,0,1
7,0,0,0,0,0,0,1,0,0,1,0,0,0,1,0,0,0,0,0,0
8,0,0,0,0,0,0,0,0,0,0,1,1,1,1,0,0,1,0,0,1
9,0,0,0,0,0,1,0,1,0,0,0,0,0,0,1,0,0,0,1,0
10,0,0,1,0,0,1,0,0,1,0,0,0,0,0,0,0,1,1,0,0
11,0,0,0,0,0,1,0,0,1,0,0,0,0,0,0,1,0,0,0,0
12,0,0,1,0,0,0,0,0,1,0,0,0,0,1,0,0,1,0,0,1
13,0,0,1,0,1,1,0,1,1,0,0,0,1,0,0,0,1,1,0,0
14,1,0,0,0,0,0,0,0,0,1,0,0,0,0,0,1,0,0,0,0
15,1,1,0,0,1,0,0,0,0,0,0,1,0,0,1,0,0,0,1,0
16,0,1,1,1,0,0,0,0,1,0,1,0,1,1,0,0,0,1,0,0
17,0,1,1,0,1,1,0,0,0,0,1,0,0,1,0,0,1,0,0,1
18,1,0,0,0,0,1,0,0,0,1,0,0,0,0,0,1,0,0,0,0
19,0,0,0,1,0,1,1,0,1,0,0,0,1,0,0,0,0,1,0,0
