,0,1,2,3,4,5,6,7,8,9
0,0,0,0,0,0,0,0,0,1,0
1,0,0,0,0,1,1,1,0,1,1
2,0,0,0,1,1,1,1,0,1,1
3,0,0,1,0,1,1,1,0,1,0
4,0,1,1,1,0,1,1,1,0,1
5,0,1,1,1,1,0,1,1,0,1
6,0,1,1,1,1,1,0,0,1,1
7,0,0,0,0,1,1,0,0,1,1
8,1,1,1,1,0,0,1,1,0,1
9,0,1,1,0,1,1,1,1,1,0
