,0,1,2,3,4,5,6,7,8,9,10,11,12,13,14,15,16,17,18,19
0,0,0,0,0,1,0,0,0,0,1,1,1,1,1,0,0,0,1,1,1
1,0,0,0,0,1,0,0,1,1,0,0,0,0,0,1,0,1,1,0,0
2,0,0,0,0,0,1,0,0,0,1,0,0,0,0,0,0,1,0,0,1
3,0,0,0,0,0,0,0,1,0,0,0,1,0,0,0,0,1,1,0,0
4,1,1,0,0,0,0,0,0,0,0,0,0,0,0,0,0,0,0,1,0
5,0,0,1,0,0,0,0,0,0,0,0,1,0,0,0,0,0,1,0,0
6,0,0,0,0,0,0,0,1,0,0,1,0,0,0,1,0,0,0,1,0
7,0,1,0,1,0,0,1,0,0,0,0,0,0,1,0,0,0,0,1,0
8,0,1,0,0,0,0,0,0,0,1,0,0,0,1,1,0,0,0,1,0
9,1,0,1,0,0,0,0,0,1,0,0,0,1,1,0,0,0,0,0,1
10,1,0,0,0,0,0,1,0,0,0,0,0,0,1,0,1,0,1,1,0
11,1,0,0,1,0,1,0,0,0,0,0,0,1,1,1,0,0,0,0,1
12,1,0,0,0,0,0,0,0,0,1,0,1,0,0,0,1,1,0,0,0
13,1,0,0,0,0,0,0,1,1,1,1,1,0,0,0,1,0,0,0,0
14,0,1,0,0,0,0,1,0,1,0,0,1,0,0,0,0,1,1,1,1
15,0,0,0,0,0,0,0,0,0,0,1,0,1,1,0,0,1,0,0,0
16,0,1,1,1,0,0,0,0,0,0,0,0,1,0,1,1,0,0,0,1
17,1,1,0,1,0,1,0,0,0,0,1,0,0,0,1,0,0,0,0,0
18,1,0,0,0,1,0,1,1,1,0,1,0,0,0,1,0,0,0,0,1
19,1,0,1,0,0,0,0,0,0,1,0,1,0,0,1,0,1,0,1,0
