,0,1,2,3,4,5,6,7,8,9,10,11,12,13,14,15,16,17,18,19
0,0,0,1,1,0,0,1,0,0,0,0,0,0,0,0,0,1,0,0,0
1,0,0,1,0,1,0,0,1,0,0,0,0,0,0,1,0,0,0,1,1
2,1,1,0,0,0,0,0,0,0,0,0,0,1,1,1,0,1,0,1,0
3,1,0,0,0,0,1,0,1,1,0,0,1,0,0,0,0,1,0,1,1
4,0,1,0,0,0,1,0,0,0,0,1,0,1,1,0,1,0,0,0,1
5,0,0,0,1,1,0,1,0,1,0,1,0,1,1,1,1,1,1,1,0
6,1,0,0,0,0,1,0,0,1,0,1,1,0,1,1,0,0,0,1,0
7,0,1,0,1,0,0,0,0,0,0,0,0,0,0,0,0,1,0,0,1
8,0,0,0,1,0,1,1,0,0,0,1,0,0,0,1,0,0,1,1,1
9,0,0,0,0,0,0,0,0,0,0,0,0,1,0,1,0,1,0,0,0
10,0,0,0,0,1,1,1,0,1,0,0,1,0,1,1,0,1,1,0,0
11,0,0,0,1,0,0,1,0,0,0,1,0,0,1,1,0,0,1,1,0
12,0,0,1,0,1,1,0,0,0,1,0,0,0,0,1,0,0,0,1,0
13,0,0,1,0,1,1,1,0,0,0,1,1,0,0,0,0,0,0,0,0
14,0,1,1,0,0,1,1,0,1,1,1,1,1,0,0,0,0,0,1,0
15,0,0,0,0,1,1,0,0,0,0,0,0,0,0,0,0,0,1,1,0
16,1,0,1,1,0,1,0,1,0,1,1,0,0,0,0,0,0,0,0,1
17,0,0,0,0,0,1,0,0,1,0,1,1,0,0,0,1,0,0,1,1
18,0,1,1,1,0,1,1,0,1,0,0,1,1,0,1,1,0,1,0,0
19,0,1,0,1,1,0,0,1,1,0,0,0,0,0,0,0,1,1,0,0