,0,1,2,3,4,5,6,7,8,9,10,11,12,13,14,15,16,17,18,19
0,0,1,1,1,0,1,1,0,0,0,0,0,0,0,1,0,0,0,0,0
1,1,0,0,1,0,0,0,1,0,0,0,1,0,0,0,0,0,1,0,0
2,1,0,0,0,0,1,0,1,1,1,0,1,0,1,0,0,0,0,0,1
3,1,1,0,0,0,1,0,1,0,0,0,1,0,0,0,0,0,0,1,1
4,0,0,0,0,0,1,0,0,0,1,0,1,0,1,0,0,0,1,0,0
5,1,0,1,1,1,0,1,0,0,1,0,0,0,0,0,0,0,0,0,0
6,1,0,0,0,0,1,0,0,1,1,0,0,0,0,0,0,0,0,0,0
7,0,1,1,1,0,0,0,0,0,0,1,0,0,0,0,0,1,0,0,1
8,0,0,1,0,0,0,1,0,0,1,0,1,0,0,0,0,0,0,0,1
9,0,0,1,0,1,1,1,0,1,0,0,0,1,1,0,1,1,0,1,1
10,0,0,0,0,0,0,0,1,0,0,0,0,0,0,0,0,1,0,0,1
11,0,1,1,1,1,0,0,0,1,0,0,0,0,0,0,0,0,1,0,0
12,0,0,0,0,0,0,0,0,0,1,0,0,0,0,0,0,0,1,1,0
13,0,0,1,0,1,0,0,0,0,1,0,0,0,0,1,0,1,0,0,1
14,1,0,0,0,0,0,0,0,0,0,0,0,0,1,0,0,0,0,0,0
15,0,0,0,0,0,0,0,0,0,1,0,0,0,0,0,0,0,0,0,1
16,0,0,0,0,0,0,0,1,0,1,1,0,0,1,0,0,0,0,0,0
17,0,1,0,0,1,0,0,0,0,0,0,1,1,0,0,0,0,0,0,0
18,0,0,0,1,0,0,0,0,0,1,0,0,1,0,0,0,0,0,0,1
19,0,0,1,1,0,0,0,1,1,1,1,0,0,1,0,1,0,0,1,0
