,0,1,2,3,4,5,6,7,8,9,10,11,12,13,14,15,16,17,18,19
0,0,1,0,1,0,1,0,1,1,0,1,1,1,1,1,1,1,0,1,1
1,1,0,0,1,1,1,0,0,0,0,0,0,0,1,0,1,0,0,0,1
2,0,0,0,0,0,1,1,0,1,1,1,0,1,1,1,1,0,0,1,0
3,1,1,0,0,1,0,1,1,0,0,1,1,0,0,1,0,1,0,1,0
4,0,1,0,1,0,0,1,0,1,0,0,0,1,1,0,0,1,1,0,0
5,1,1,1,0,0,0,1,0,1,0,1,1,1,0,1,0,0,0,0,1
6,0,0,1,1,1,1,0,1,0,0,0,1,0,0,1,1,0,1,1,1
7,1,0,0,1,0,0,1,0,0,1,0,0,1,1,1,0,0,1,1,0
8,1,0,1,0,1,1,0,0,0,0,0,0,0,0,1,1,0,1,0,1
9,0,0,1,0,0,0,0,1,0,0,1,1,1,0,1,1,0,1,1,1
10,1,0,1,1,0,1,0,0,0,1,0,0,1,0,1,1,0,1,1,0
11,1,0,0,1,0,1,1,0,0,1,0,0,1,1,0,0,0,0,0,1
12,1,0,1,0,1,1,0,1,0,1,1,1,0,0,0,0,0,1,1,0
13,1,1,1,0,1,0,0,1,0,0,0,1,0,0,1,1,1,0,1,0
14,1,0,1,1,0,1,1,1,1,1,1,0,0,1,0,0,1,0,0,0
15,1,1,1,0,0,0,1,0,1,1,1,0,0,1,0,0,1,0,0,1
16,1,0,0,1,1,0,0,0,0,0,0,0,0,1,1,1,0,0,1,1
17,0,0,0,0,1,0,1,1,1,1,1,0,1,0,0,0,0,0,1,0
18,1,0,1,1,0,0,1,1,0,1,1,0,1,1,0,0,1,1,0,0
19,1,1,0,0,0,1,1,0,1,1,0,1,0,0,0,1,1,0,0,0
