,0,1,2,3,4,5,6,7,8,9,10,11,12,13,14,15,16,17,18,19
0,0,1,1,0,1,1,0,0,1,1,0,0,0,1,0,1,0,1,0,0
1,1,0,1,0,0,0,0,1,1,1,1,0,0,0,0,1,1,0,0,0
2,1,1,0,0,0,1,0,1,0,1,0,0,1,1,1,0,0,1,1,0
3,0,0,0,0,1,1,0,0,0,1,1,0,0,1,0,1,1,1,1,1
4,1,0,0,1,0,0,1,0,1,0,1,0,1,1,0,0,0,1,0,0
5,1,0,1,1,0,0,1,1,0,1,1,0,1,1,1,0,0,1,0,1
6,0,0,0,0,1,1,0,0,1,1,0,1,1,0,0,0,1,1,1,0
7,0,1,1,0,0,1,0,0,0,1,1,0,1,1,1,1,0,1,1,0
8,1,1,0,0,1,0,1,0,0,1,0,0,1,1,0,1,0,1,1,1
9,1,1,1,1,0,1,1,1,1,0,1,0,0,1,1,0,0,0,0,1
10,0,1,0,1,1,1,0,1,0,1,0,1,0,0,1,0,1,0,1,0
11,0,0,0,0,0,0,1,0,0,0,1,0,0,0,0,1,1,0,1,0
12,0,0,1,0,1,1,1,1,1,0,0,0,0,0,1,1,0,0,0,1
13,1,0,1,1,1,1,0,1,1,1,0,0,0,0,0,0,0,1,0,0
14,0,0,1,0,0,1,0,1,0,1,1,0,1,0,0,1,0,0,0,1
15,1,1,0,1,0,0,0,1,1,0,0,1,1,0,1,0,0,1,0,1
16,0,1,0,1,0,0,1,0,0,0,1,1,0,0,0,0,0,1,1,1
17,1,0,1,1,1,1,1,1,1,0,0,0,0,1,0,1,1,0,0,1
18,0,0,1,1,0,0,1,1,1,0,1,1,0,0,0,0,1,0,0,1
19,0,0,0,1,0,1,0,0,1,1,0,0,1,0,1,1,1,1,1,0
