,0,1,2,3,4,5,6,7,8,9,10,11,12,13,14,15,16,17,18,19
0,0,1,0,0,1,1,0,0,0,1,0,1,0,1,1,1,1,0,0,1
1,1,0,0,1,1,0,0,1,1,0,1,0,0,1,1,0,1,1,0,1
2,0,0,0,1,1,0,1,1,0,0,1,1,0,0,1,0,1,0,0,0
3,0,1,1,0,1,1,1,1,1,0,1,1,0,1,0,0,0,0,0,1
4,1,1,1,1,0,1,1,1,1,0,0,1,1,1,1,0,1,1,0,1
5,1,0,0,1,1,0,1,1,0,1,0,0,1,1,0,1,1,0,1,0
6,0,0,1,1,1,1,0,1,0,1,0,1,0,0,0,1,0,1,0,0
7,0,1,1,1,1,1,1,0,0,1,0,0,1,0,1,0,1,1,1,1
8,0,1,0,1,1,0,0,0,0,1,1,0,0,1,0,0,0,0,0,0
9,1,0,0,0,0,1,1,1,1,0,1,1,0,0,1,1,1,1,1,1
10,0,1,1,1,0,0,0,0,1,1,0,0,0,1,1,0,1,1,0,1
11,1,0,1,1,1,0,1,0,0,1,0,0,1,0,0,1,1,1,1,1
12,0,0,0,0,1,1,0,1,0,0,0,1,0,1,1,1,0,0,1,0
13,1,1,0,1,1,1,0,0,1,0,1,0,1,0,1,0,1,1,1,1
14,1,1,1,0,1,0,0,1,0,1,1,0,1,1,0,0,0,1,0,1
15,1,0,0,0,0,1,1,0,0,1,0,1,1,0,0,0,0,1,1,1
16,1,1,1,0,1,1,0,1,0,1,1,1,0,1,0,0,0,1,1,0
17,0,1,0,0,1,0,1,1,0,1,1,1,0,1,1,1,1,0,1,1
18,0,0,0,0,0,1,0,1,0,1,0,1,1,1,0,1,1,1,0,1
19,1,1,0,1,1,0,0,1,0,1,1,1,0,1,1,1,0,1,1,0
