,0,1,2,3,4,5,6,7,8,9,10,11,12,13,14,15,16,17,18,19
0,0,0,0,1,1,0,1,1,1,0,1,1,1,0,1,1,1,1,1,1
1,0,0,0,1,0,0,1,0,0,0,0,1,1,1,1,0,0,0,0,1
2,0,0,0,0,1,0,1,1,1,1,1,0,0,1,1,1,0,1,0,1
3,1,1,0,0,1,0,1,0,1,0,1,1,0,1,1,0,0,1,1,0
4,1,0,1,1,0,1,1,0,1,1,1,0,1,0,0,0,0,0,1,0
5,0,0,0,0,1,0,0,1,1,0,1,1,1,1,1,0,1,1,1,0
6,1,1,1,1,1,0,0,1,1,0,1,0,1,0,0,0,0,1,0,0
7,1,0,1,0,0,1,1,0,1,0,0,0,0,1,0,0,1,0,0,0
8,1,0,1,1,1,1,1,1,0,0,1,0,1,0,0,1,0,1,0,0
9,0,0,1,0,1,0,0,0,0,0,0,0,1,0,0,0,1,1,1,0
10,1,0,1,1,1,1,1,0,1,0,0,0,1,0,0,1,1,1,0,1
11,1,1,0,1,0,1,0,0,0,0,0,0,0,0,0,0,1,0,1,0
12,1,1,0,0,1,1,1,0,1,1,1,0,0,1,1,1,1,0,0,1
13,0,1,1,1,0,1,0,1,0,0,0,0,1,0,1,0,1,1,0,1
14,1,1,1,1,0,1,0,0,0,0,0,0,1,1,0,1,1,0,1,1
15,1,0,1,0,0,0,0,0,1,0,1,0,1,0,1,0,0,1,1,0
16,1,0,0,0,0,1,0,1,0,1,1,1,1,1,1,0,0,1,0,0
17,1,0,1,1,0,1,1,0,1,1,1,0,0,1,0,1,1,0,1,0
18,1,0,0,1,1,1,0,0,0,1,0,1,0,0,1,1,0,1,0,0
19,1,1,1,0,0,0,0,0,0,0,1,0,1,1,1,0,0,0,0,0
