,0,1,2,3,4,5,6,7,8,9
0,0,0,0,0,1,0,0,1,1,0
1,0,0,1,0,0,1,0,1,1,1
2,0,1,0,0,1,0,0,0,0,1
3,0,0,0,0,0,0,1,0,0,1
4,1,0,1,0,0,0,1,0,0,0
5,0,1,0,0,0,0,1,0,0,0
6,0,0,0,1,1,1,0,0,0,0
7,1,1,0,0,0,0,0,0,1,0
8,1,1,0,0,0,0,0,1,0,0
9,0,1,1,1,0,0,0,0,0,0
