,0,1,2,3,4,5,6,7,8,9
0,0,0,1,0,0,1,0,0,0,0
1,0,0,0,1,1,1,0,0,0,1
2,1,0,0,1,0,0,0,1,1,0
3,0,1,1,0,1,1,1,0,0,0
4,0,1,0,1,0,0,0,0,0,0
5,1,1,0,1,0,0,1,0,0,0
6,0,0,0,1,0,1,0,1,1,1
7,0,0,1,0,0,0,1,0,0,0
8,0,0,1,0,0,0,1,0,0,0
9,0,1,0,0,0,0,1,0,0,0
